"filename", "language", "JSON", "JavaScript", "JSON with Comments", "Markdown", "Log", "comment", "blank", "total"
"c:\Users\eloua\OneDrive\Bureau\DiscordJS\ObanaiDiscordBot\.eslintrc.json", "JSON with Comments", 0, 0, 47, 0, 0, 0, 1, 48
"c:\Users\eloua\OneDrive\Bureau\DiscordJS\ObanaiDiscordBot\changelog.md", "Markdown", 0, 0, 0, 38, 0, 0, 18, 56
"c:\Users\eloua\OneDrive\Bureau\DiscordJS\ObanaiDiscordBot\obanaibot-error.log", "Log", 0, 0, 0, 0, 2506, 0, 159, 2665
"c:\Users\eloua\OneDrive\Bureau\DiscordJS\ObanaiDiscordBot\package-lock.json", "JSON", 7105, 0, 0, 0, 0, 0, 1, 7106
"c:\Users\eloua\OneDrive\Bureau\DiscordJS\ObanaiDiscordBot\package.json", "JSON", 21, 0, 0, 0, 0, 0, 0, 21
"c:\Users\eloua\OneDrive\Bureau\DiscordJS\ObanaiDiscordBot\src\base\Command.js", "JavaScript", 0, 238, 0, 0, 0, 4, 34, 276
"c:\Users\eloua\OneDrive\Bureau\DiscordJS\ObanaiDiscordBot\src\base\CommandManager.js", "JavaScript", 0, 35, 0, 0, 0, 1, 8, 44
"c:\Users\eloua\OneDrive\Bureau\DiscordJS\ObanaiDiscordBot\src\base\Context.js", "JavaScript", 0, 262, 0, 0, 0, 37, 58, 357
"c:\Users\eloua\OneDrive\Bureau\DiscordJS\ObanaiDiscordBot\src\base\Obanai.js", "JavaScript", 0, 113, 0, 0, 0, 9, 16, 138
"c:\Users\eloua\OneDrive\Bureau\DiscordJS\ObanaiDiscordBot\src\base\SuperButton.js", "JavaScript", 0, 48, 0, 0, 0, 0, 15, 63
"c:\Users\eloua\OneDrive\Bureau\DiscordJS\ObanaiDiscordBot\src\base\SuperEmbed.js", "JavaScript", 0, 78, 0, 0, 0, 0, 14, 92
"c:\Users\eloua\OneDrive\Bureau\DiscordJS\ObanaiDiscordBot\src\base\SuperModal.js", "JavaScript", 0, 34, 0, 0, 0, 0, 11, 45
"c:\Users\eloua\OneDrive\Bureau\DiscordJS\ObanaiDiscordBot\src\base\SuperModalTextInput.js", "JavaScript", 0, 31, 0, 0, 0, 0, 7, 38
"c:\Users\eloua\OneDrive\Bureau\DiscordJS\ObanaiDiscordBot\src\base\SuperModalTextInputComponent.js", "JavaScript", 0, 59, 0, 0, 0, 0, 18, 77
"c:\Users\eloua\OneDrive\Bureau\DiscordJS\ObanaiDiscordBot\src\base\SuperRow.js", "JavaScript", 0, 15, 0, 0, 0, 0, 4, 19
"c:\Users\eloua\OneDrive\Bureau\DiscordJS\ObanaiDiscordBot\src\base\SuperSelectMenu.js", "JavaScript", 0, 59, 0, 0, 0, 0, 17, 76
"c:\Users\eloua\OneDrive\Bureau\DiscordJS\ObanaiDiscordBot\src\base\SuperSelectMenuOption.js", "JavaScript", 0, 35, 0, 0, 0, 0, 13, 48
"c:\Users\eloua\OneDrive\Bureau\DiscordJS\ObanaiDiscordBot\src\classes\Arena.js", "JavaScript", 0, 395, 0, 0, 0, 1, 57, 453
"c:\Users\eloua\OneDrive\Bureau\DiscordJS\ObanaiDiscordBot\src\classes\Player.js", "JavaScript", 0, 20, 0, 0, 0, 0, 3, 23
"c:\Users\eloua\OneDrive\Bureau\DiscordJS\ObanaiDiscordBot\src\classes\Team.js", "JavaScript", 0, 30, 0, 0, 0, 0, 7, 37
"c:\Users\eloua\OneDrive\Bureau\DiscordJS\ObanaiDiscordBot\src\classes\buttons\attack.js", "JavaScript", 0, 44, 0, 0, 0, 0, 0, 44
"c:\Users\eloua\OneDrive\Bureau\DiscordJS\ObanaiDiscordBot\src\classes\buttons\choiceinfos.json", "JSON", 16, 0, 0, 0, 0, 0, 0, 16
"c:\Users\eloua\OneDrive\Bureau\DiscordJS\ObanaiDiscordBot\src\classes\buttons\defense.js", "JavaScript", 0, 32, 0, 0, 0, 0, 0, 32
"c:\Users\eloua\OneDrive\Bureau\DiscordJS\ObanaiDiscordBot\src\commands\admin\add-serv.js", "JavaScript", 0, 23, 0, 0, 0, 0, 3, 26
"c:\Users\eloua\OneDrive\Bureau\DiscordJS\ObanaiDiscordBot\src\commands\admin\change-status.js", "JavaScript", 0, 38, 0, 0, 0, 0, 4, 42
"c:\Users\eloua\OneDrive\Bureau\DiscordJS\ObanaiDiscordBot\src\commands\admin\remove-serv.js", "JavaScript", 0, 28, 0, 0, 0, 0, 3, 31
"c:\Users\eloua\OneDrive\Bureau\DiscordJS\ObanaiDiscordBot\src\commands\admin\set-vip.js", "JavaScript", 0, 35, 0, 0, 0, 0, 6, 41
"c:\Users\eloua\OneDrive\Bureau\DiscordJS\ObanaiDiscordBot\src\commands\admin\set-vipplus.js", "JavaScript", 0, 35, 0, 0, 0, 0, 6, 41
"c:\Users\eloua\OneDrive\Bureau\DiscordJS\ObanaiDiscordBot\src\commands\admin\unset-vip.js", "JavaScript", 0, 35, 0, 0, 0, 0, 6, 41
"c:\Users\eloua\OneDrive\Bureau\DiscordJS\ObanaiDiscordBot\src\commands\admin\unset-vipplus.js", "JavaScript", 0, 35, 0, 0, 0, 0, 6, 41
"c:\Users\eloua\OneDrive\Bureau\DiscordJS\ObanaiDiscordBot\src\commands\combats\fight.js", "JavaScript", 0, 153, 0, 0, 0, 3, 26, 182
"c:\Users\eloua\OneDrive\Bureau\DiscordJS\ObanaiDiscordBot\src\commands\escouades\squad-create.js", "JavaScript", 0, 95, 0, 0, 0, 0, 8, 103
"c:\Users\eloua\OneDrive\Bureau\DiscordJS\ObanaiDiscordBot\src\commands\escouades\squad-delete.js", "JavaScript", 0, 96, 0, 0, 0, 0, 8, 104
"c:\Users\eloua\OneDrive\Bureau\DiscordJS\ObanaiDiscordBot\src\commands\escouades\squad-demote.js", "JavaScript", 0, 85, 0, 0, 0, 0, 8, 93
"c:\Users\eloua\OneDrive\Bureau\DiscordJS\ObanaiDiscordBot\src\commands\escouades\squad-invite.js", "JavaScript", 0, 149, 0, 0, 0, 3, 17, 169
"c:\Users\eloua\OneDrive\Bureau\DiscordJS\ObanaiDiscordBot\src\commands\escouades\squad-kick.js", "JavaScript", 0, 103, 0, 0, 0, 0, 10, 113
"c:\Users\eloua\OneDrive\Bureau\DiscordJS\ObanaiDiscordBot\src\commands\escouades\squad-leave.js", "JavaScript", 0, 78, 0, 0, 0, 0, 8, 86
"c:\Users\eloua\OneDrive\Bureau\DiscordJS\ObanaiDiscordBot\src\commands\escouades\squad-promote.js", "JavaScript", 0, 112, 0, 0, 0, 0, 10, 122
"c:\Users\eloua\OneDrive\Bureau\DiscordJS\ObanaiDiscordBot\src\commands\escouades\squad-quote.js", "JavaScript", 0, 93, 0, 0, 0, 0, 9, 102
"c:\Users\eloua\OneDrive\Bureau\DiscordJS\ObanaiDiscordBot\src\commands\escouades\squad-rename.js", "JavaScript", 0, 84, 0, 0, 0, 0, 9, 93
"c:\Users\eloua\OneDrive\Bureau\DiscordJS\ObanaiDiscordBot\src\commands\escouades\squad.js", "JavaScript", 0, 65, 0, 0, 0, 0, 13, 78
"c:\Users\eloua\OneDrive\Bureau\DiscordJS\ObanaiDiscordBot\src\commands\exploration\crow-bait.js", "JavaScript", 0, 162, 0, 0, 0, 2, 23, 187
"c:\Users\eloua\OneDrive\Bureau\DiscordJS\ObanaiDiscordBot\src\commands\exploration\crow-feed.js", "JavaScript", 0, 102, 0, 0, 0, 1, 15, 118
"c:\Users\eloua\OneDrive\Bureau\DiscordJS\ObanaiDiscordBot\src\commands\exploration\dig.js", "JavaScript", 0, 164, 0, 0, 0, 2, 22, 188
"c:\Users\eloua\OneDrive\Bureau\DiscordJS\ObanaiDiscordBot\src\commands\exploration\forge-collect.js", "JavaScript", 0, 66, 0, 0, 0, 0, 12, 78
"c:\Users\eloua\OneDrive\Bureau\DiscordJS\ObanaiDiscordBot\src\commands\exploration\forge-list.js", "JavaScript", 0, 54, 0, 0, 0, 0, 9, 63
"c:\Users\eloua\OneDrive\Bureau\DiscordJS\ObanaiDiscordBot\src\commands\exploration\forge-weapon.js", "JavaScript", 0, 142, 0, 0, 0, 0, 9, 151
"c:\Users\eloua\OneDrive\Bureau\DiscordJS\ObanaiDiscordBot\src\commands\exploration\grimoire-enchant.js", "JavaScript", 0, 95, 0, 0, 0, 0, 7, 102
"c:\Users\eloua\OneDrive\Bureau\DiscordJS\ObanaiDiscordBot\src\commands\exploration\map.js", "JavaScript", 0, 47, 0, 0, 0, 0, 12, 59
"c:\Users\eloua\OneDrive\Bureau\DiscordJS\ObanaiDiscordBot\src\commands\exploration\travel-area.js", "JavaScript", 0, 85, 0, 0, 0, 0, 12, 97
"c:\Users\eloua\OneDrive\Bureau\DiscordJS\ObanaiDiscordBot\src\commands\exploration\travel-region.js", "JavaScript", 0, 88, 0, 0, 0, 2, 13, 103
"c:\Users\eloua\OneDrive\Bureau\DiscordJS\ObanaiDiscordBot\src\commands\owner\clear-db.js", "JavaScript", 0, 27, 0, 0, 0, 0, 3, 30
"c:\Users\eloua\OneDrive\Bureau\DiscordJS\ObanaiDiscordBot\src\commands\owner\eval.js", "JavaScript", 0, 43, 0, 0, 0, 0, 7, 50
"c:\Users\eloua\OneDrive\Bureau\DiscordJS\ObanaiDiscordBot\src\commands\quetes\give.js", "JavaScript", 0, 97, 0, 0, 0, 0, 15, 112
"c:\Users\eloua\OneDrive\Bureau\DiscordJS\ObanaiDiscordBot\src\commands\quetes\inspect.js", "JavaScript", 0, 84, 0, 0, 0, 0, 16, 100
"c:\Users\eloua\OneDrive\Bureau\DiscordJS\ObanaiDiscordBot\src\commands\quetes\quests.js", "JavaScript", 0, 179, 0, 0, 0, 2, 19, 200
"c:\Users\eloua\OneDrive\Bureau\DiscordJS\ObanaiDiscordBot\src\commands\quetes\talk.js", "JavaScript", 0, 81, 0, 0, 0, 0, 14, 95
"c:\Users\eloua\OneDrive\Bureau\DiscordJS\ObanaiDiscordBot\src\commands\stats\badges.js", "JavaScript", 0, 38, 0, 0, 0, 0, 9, 47
"c:\Users\eloua\OneDrive\Bureau\DiscordJS\ObanaiDiscordBot\src\commands\stats\category.js", "JavaScript", 0, 105, 0, 0, 0, 0, 16, 121
"c:\Users\eloua\OneDrive\Bureau\DiscordJS\ObanaiDiscordBot\src\commands\stats\claim.js", "JavaScript", 0, 53, 0, 0, 0, 0, 10, 63
"c:\Users\eloua\OneDrive\Bureau\DiscordJS\ObanaiDiscordBot\src\commands\stats\crow.js", "JavaScript", 0, 51, 0, 0, 0, 0, 12, 63
"c:\Users\eloua\OneDrive\Bureau\DiscordJS\ObanaiDiscordBot\src\commands\stats\grimoire-set.js", "JavaScript", 0, 69, 0, 0, 0, 0, 12, 81
"c:\Users\eloua\OneDrive\Bureau\DiscordJS\ObanaiDiscordBot\src\commands\stats\grimoire-unset.js", "JavaScript", 0, 48, 0, 0, 0, 0, 6, 54
"c:\Users\eloua\OneDrive\Bureau\DiscordJS\ObanaiDiscordBot\src\commands\stats\grimoires.js", "JavaScript", 0, 61, 0, 0, 0, 0, 9, 70
"c:\Users\eloua\OneDrive\Bureau\DiscordJS\ObanaiDiscordBot\src\commands\stats\inventory.js", "JavaScript", 0, 45, 0, 0, 0, 0, 8, 53
"c:\Users\eloua\OneDrive\Bureau\DiscordJS\ObanaiDiscordBot\src\commands\stats\lang.js", "JavaScript", 0, 40, 0, 0, 0, 0, 4, 44
"c:\Users\eloua\OneDrive\Bureau\DiscordJS\ObanaiDiscordBot\src\commands\stats\rank.js", "JavaScript", 0, 50, 0, 0, 0, 0, 10, 60
"c:\Users\eloua\OneDrive\Bureau\DiscordJS\ObanaiDiscordBot\src\commands\stats\reset.js", "JavaScript", 0, 47, 0, 0, 0, 0, 4, 51
"c:\Users\eloua\OneDrive\Bureau\DiscordJS\ObanaiDiscordBot\src\commands\stats\start.js", "JavaScript", 0, 53, 0, 0, 0, 0, 4, 57
"c:\Users\eloua\OneDrive\Bureau\DiscordJS\ObanaiDiscordBot\src\commands\stats\stats.js", "JavaScript", 0, 42, 0, 0, 0, 0, 12, 54
"c:\Users\eloua\OneDrive\Bureau\DiscordJS\ObanaiDiscordBot\src\commands\stats\top.js", "JavaScript", 0, 33, 0, 0, 0, 0, 8, 41
"c:\Users\eloua\OneDrive\Bureau\DiscordJS\ObanaiDiscordBot\src\commands\stats\train.js", "JavaScript", 0, 95, 0, 0, 0, 0, 9, 104
"c:\Users\eloua\OneDrive\Bureau\DiscordJS\ObanaiDiscordBot\src\commands\stats\weapon-sell.js", "JavaScript", 0, 92, 0, 0, 0, 0, 14, 106
"c:\Users\eloua\OneDrive\Bureau\DiscordJS\ObanaiDiscordBot\src\commands\stats\weapon-set.js", "JavaScript", 0, 104, 0, 0, 0, 0, 15, 119
"c:\Users\eloua\OneDrive\Bureau\DiscordJS\ObanaiDiscordBot\src\commands\stats\weapons.js", "JavaScript", 0, 34, 0, 0, 0, 0, 8, 42
"c:\Users\eloua\OneDrive\Bureau\DiscordJS\ObanaiDiscordBot\src\commands\testing\bot-infos.js", "JavaScript", 0, 44, 0, 0, 0, 0, 6, 50
"c:\Users\eloua\OneDrive\Bureau\DiscordJS\ObanaiDiscordBot\src\commands\testing\status.js", "JavaScript", 0, 86, 0, 0, 0, 3, 15, 104
"c:\Users\eloua\OneDrive\Bureau\DiscordJS\ObanaiDiscordBot\src\commands\testing\testing.js", "JavaScript", 0, 21, 0, 0, 0, 0, 3, 24
"c:\Users\eloua\OneDrive\Bureau\DiscordJS\ObanaiDiscordBot\src\commands\utilitaire\help.js", "JavaScript", 0, 305, 0, 0, 0, 0, 21, 326
"c:\Users\eloua\OneDrive\Bureau\DiscordJS\ObanaiDiscordBot\src\commands\utilitaire\prefix.js", "JavaScript", 0, 61, 0, 0, 0, 0, 4, 65
"c:\Users\eloua\OneDrive\Bureau\DiscordJS\ObanaiDiscordBot\src\config.json", "JSON", 17, 0, 0, 0, 0, 0, 0, 17
"c:\Users\eloua\OneDrive\Bureau\DiscordJS\ObanaiDiscordBot\src\elements\badgesObjectives.json", "JSON", 48, 0, 0, 0, 0, 0, 0, 48
"c:\Users\eloua\OneDrive\Bureau\DiscordJS\ObanaiDiscordBot\src\elements\breaths\beast_style.json", "JSON", 33, 0, 0, 0, 0, 0, 0, 33
"c:\Users\eloua\OneDrive\Bureau\DiscordJS\ObanaiDiscordBot\src\elements\breaths\flame_style.json", "JSON", 31, 0, 0, 0, 0, 0, 0, 31
"c:\Users\eloua\OneDrive\Bureau\DiscordJS\ObanaiDiscordBot\src\elements\breaths\flower_style.json", "JSON", 30, 0, 0, 0, 0, 0, 0, 30
"c:\Users\eloua\OneDrive\Bureau\DiscordJS\ObanaiDiscordBot\src\elements\breaths\insect_style.json", "JSON", 31, 0, 0, 0, 0, 0, 0, 31
"c:\Users\eloua\OneDrive\Bureau\DiscordJS\ObanaiDiscordBot\src\elements\breaths\love_style.json", "JSON", 30, 0, 0, 0, 0, 0, 0, 30
"c:\Users\eloua\OneDrive\Bureau\DiscordJS\ObanaiDiscordBot\src\elements\breaths\mist_style.json", "JSON", 30, 0, 0, 0, 0, 0, 0, 30
"c:\Users\eloua\OneDrive\Bureau\DiscordJS\ObanaiDiscordBot\src\elements\breaths\moon_style.json", "JSON", 33, 0, 0, 0, 0, 0, 0, 33
"c:\Users\eloua\OneDrive\Bureau\DiscordJS\ObanaiDiscordBot\src\elements\breaths\serpent_style.json", "JSON", 30, 0, 0, 0, 0, 0, 0, 30
"c:\Users\eloua\OneDrive\Bureau\DiscordJS\ObanaiDiscordBot\src\elements\breaths\sound_style.json", "JSON", 30, 0, 0, 0, 0, 0, 0, 30
"c:\Users\eloua\OneDrive\Bureau\DiscordJS\ObanaiDiscordBot\src\elements\breaths\stone_style.json", "JSON", 30, 0, 0, 0, 0, 0, 0, 30
"c:\Users\eloua\OneDrive\Bureau\DiscordJS\ObanaiDiscordBot\src\elements\breaths\sun_style.json", "JSON", 35, 0, 0, 0, 0, 0, 0, 35
"c:\Users\eloua\OneDrive\Bureau\DiscordJS\ObanaiDiscordBot\src\elements\breaths\thunder_style.json", "JSON", 33, 0, 0, 0, 0, 0, 0, 33
"c:\Users\eloua\OneDrive\Bureau\DiscordJS\ObanaiDiscordBot\src\elements\breaths\water_style.json", "JSON", 36, 0, 0, 0, 0, 0, 0, 36
"c:\Users\eloua\OneDrive\Bureau\DiscordJS\ObanaiDiscordBot\src\elements\breaths\wind_style.json", "JSON", 31, 0, 0, 0, 0, 0, 0, 31
"c:\Users\eloua\OneDrive\Bureau\DiscordJS\ObanaiDiscordBot\src\elements\calcCrowLevel.js", "JavaScript", 0, 18, 0, 0, 0, 0, 3, 21
"c:\Users\eloua\OneDrive\Bureau\DiscordJS\ObanaiDiscordBot\src\elements\calcPlayerLevel.js", "JavaScript", 0, 18, 0, 0, 0, 0, 3, 21
"c:\Users\eloua\OneDrive\Bureau\DiscordJS\ObanaiDiscordBot\src\elements\categories\butterfly.json", "JSON", 17, 0, 0, 0, 0, 0, 0, 17
"c:\Users\eloua\OneDrive\Bureau\DiscordJS\ObanaiDiscordBot\src\elements\categories\cactus.json", "JSON", 17, 0, 0, 0, 0, 0, 0, 17
"c:\Users\eloua\OneDrive\Bureau\DiscordJS\ObanaiDiscordBot\src\elements\categories\charmer.json", "JSON", 17, 0, 0, 0, 0, 0, 0, 17
"c:\Users\eloua\OneDrive\Bureau\DiscordJS\ObanaiDiscordBot\src\elements\categories\gymnast.json", "JSON", 17, 0, 0, 0, 0, 0, 0, 17
"c:\Users\eloua\OneDrive\Bureau\DiscordJS\ObanaiDiscordBot\src\elements\categories\moon_tamer.json", "JSON", 17, 0, 0, 0, 0, 0, 0, 17
"c:\Users\eloua\OneDrive\Bureau\DiscordJS\ObanaiDiscordBot\src\elements\categories\ninja.json", "JSON", 17, 0, 0, 0, 0, 0, 0, 17
"c:\Users\eloua\OneDrive\Bureau\DiscordJS\ObanaiDiscordBot\src\elements\categories\shredding.json", "JSON", 17, 0, 0, 0, 0, 0, 0, 17
"c:\Users\eloua\OneDrive\Bureau\DiscordJS\ObanaiDiscordBot\src\elements\categories\slayer.json", "JSON", 17, 0, 0, 0, 0, 0, 0, 17
"c:\Users\eloua\OneDrive\Bureau\DiscordJS\ObanaiDiscordBot\src\elements\grimoires\adventurer.json", "JSON", 8, 0, 0, 0, 0, 0, 0, 8
"c:\Users\eloua\OneDrive\Bureau\DiscordJS\ObanaiDiscordBot\src\elements\grimoires\economist.json", "JSON", 8, 0, 0, 0, 0, 0, 0, 8
"c:\Users\eloua\OneDrive\Bureau\DiscordJS\ObanaiDiscordBot\src\elements\grimoires\eternal.json", "JSON", 16, 0, 0, 0, 0, 0, 0, 16
"c:\Users\eloua\OneDrive\Bureau\DiscordJS\ObanaiDiscordBot\src\elements\grimoires\falconer.json", "JSON", 8, 0, 0, 0, 0, 0, 0, 8
"c:\Users\eloua\OneDrive\Bureau\DiscordJS\ObanaiDiscordBot\src\elements\grimoires\fortunate.json", "JSON", 8, 0, 0, 0, 0, 0, 0, 8
"c:\Users\eloua\OneDrive\Bureau\DiscordJS\ObanaiDiscordBot\src\elements\grimoires\mastery.json", "JSON", 8, 0, 0, 0, 0, 0, 0, 8
"c:\Users\eloua\OneDrive\Bureau\DiscordJS\ObanaiDiscordBot\src\elements\grimoires\warrior.json", "JSON", 8, 0, 0, 0, 0, 0, 0, 8
"c:\Users\eloua\OneDrive\Bureau\DiscordJS\ObanaiDiscordBot\src\elements\kasugai_crows\dove.json", "JSON", 6, 0, 0, 0, 0, 0, 0, 6
"c:\Users\eloua\OneDrive\Bureau\DiscordJS\ObanaiDiscordBot\src\elements\kasugai_crows\kasugai_evolved.json", "JSON", 6, 0, 0, 0, 0, 0, 0, 6
"c:\Users\eloua\OneDrive\Bureau\DiscordJS\ObanaiDiscordBot\src\elements\kasugai_crows\kasugai_proud.json", "JSON", 6, 0, 0, 0, 0, 0, 0, 6
"c:\Users\eloua\OneDrive\Bureau\DiscordJS\ObanaiDiscordBot\src\elements\kasugai_crows\kasugai_simple.json", "JSON", 6, 0, 0, 0, 0, 0, 0, 6
"c:\Users\eloua\OneDrive\Bureau\DiscordJS\ObanaiDiscordBot\src\elements\kasugai_crows\sparrow.json", "JSON", 6, 0, 0, 0, 0, 0, 0, 6
"c:\Users\eloua\OneDrive\Bureau\DiscordJS\ObanaiDiscordBot\src\elements\map.js", "JavaScript", 0, 11, 0, 0, 0, 0, 3, 14
"c:\Users\eloua\OneDrive\Bureau\DiscordJS\ObanaiDiscordBot\src\elements\map\0.json", "JSON", 22, 0, 0, 0, 0, 0, 0, 22
"c:\Users\eloua\OneDrive\Bureau\DiscordJS\ObanaiDiscordBot\src\elements\map\1.json", "JSON", 22, 0, 0, 0, 0, 0, 0, 22
"c:\Users\eloua\OneDrive\Bureau\DiscordJS\ObanaiDiscordBot\src\elements\map\10.json", "JSON", 16, 0, 0, 0, 0, 0, 0, 16
"c:\Users\eloua\OneDrive\Bureau\DiscordJS\ObanaiDiscordBot\src\elements\map\11.json", "JSON", 16, 0, 0, 0, 0, 0, 0, 16
"c:\Users\eloua\OneDrive\Bureau\DiscordJS\ObanaiDiscordBot\src\elements\map\12.json", "JSON", 16, 0, 0, 0, 0, 0, 0, 16
"c:\Users\eloua\OneDrive\Bureau\DiscordJS\ObanaiDiscordBot\src\elements\map\2.json", "JSON", 22, 0, 0, 0, 0, 0, 0, 22
"c:\Users\eloua\OneDrive\Bureau\DiscordJS\ObanaiDiscordBot\src\elements\map\3.json", "JSON", 22, 0, 0, 0, 0, 0, 0, 22
"c:\Users\eloua\OneDrive\Bureau\DiscordJS\ObanaiDiscordBot\src\elements\map\4.json", "JSON", 34, 0, 0, 0, 0, 0, 0, 34
"c:\Users\eloua\OneDrive\Bureau\DiscordJS\ObanaiDiscordBot\src\elements\map\5.json", "JSON", 16, 0, 0, 0, 0, 0, 0, 16
"c:\Users\eloua\OneDrive\Bureau\DiscordJS\ObanaiDiscordBot\src\elements\map\6.json", "JSON", 16, 0, 0, 0, 0, 0, 0, 16
"c:\Users\eloua\OneDrive\Bureau\DiscordJS\ObanaiDiscordBot\src\elements\map\7.json", "JSON", 16, 0, 0, 0, 0, 0, 0, 16
"c:\Users\eloua\OneDrive\Bureau\DiscordJS\ObanaiDiscordBot\src\elements\map\8.json", "JSON", 16, 0, 0, 0, 0, 0, 0, 16
"c:\Users\eloua\OneDrive\Bureau\DiscordJS\ObanaiDiscordBot\src\elements\map\9.json", "JSON", 34, 0, 0, 0, 0, 0, 0, 34
"c:\Users\eloua\OneDrive\Bureau\DiscordJS\ObanaiDiscordBot\src\elements\materials\grimoire.json", "JSON", 8, 0, 0, 0, 0, 0, 0, 8
"c:\Users\eloua\OneDrive\Bureau\DiscordJS\ObanaiDiscordBot\src\elements\materials\leather.json", "JSON", 8, 0, 0, 0, 0, 0, 0, 8
"c:\Users\eloua\OneDrive\Bureau\DiscordJS\ObanaiDiscordBot\src\elements\materials\paper.json", "JSON", 8, 0, 0, 0, 0, 0, 0, 8
"c:\Users\eloua\OneDrive\Bureau\DiscordJS\ObanaiDiscordBot\src\elements\materials\seed.json", "JSON", 8, 0, 0, 0, 0, 0, 0, 8
"c:\Users\eloua\OneDrive\Bureau\DiscordJS\ObanaiDiscordBot\src\elements\materials\tamahagane.json", "JSON", 8, 0, 0, 0, 0, 0, 0, 8
"c:\Users\eloua\OneDrive\Bureau\DiscordJS\ObanaiDiscordBot\src\elements\materials\weapon_model.json", "JSON", 8, 0, 0, 0, 0, 0, 0, 8
"c:\Users\eloua\OneDrive\Bureau\DiscordJS\ObanaiDiscordBot\src\elements\materials\wood.json", "JSON", 8, 0, 0, 0, 0, 0, 0, 8
"c:\Users\eloua\OneDrive\Bureau\DiscordJS\ObanaiDiscordBot\src\elements\materials\worm.json", "JSON", 8, 0, 0, 0, 0, 0, 0, 8
"c:\Users\eloua\OneDrive\Bureau\DiscordJS\ObanaiDiscordBot\src\elements\pnjs\pnj0.json", "JSON", 4, 0, 0, 0, 0, 0, 0, 4
"c:\Users\eloua\OneDrive\Bureau\DiscordJS\ObanaiDiscordBot\src\elements\pnjs\pnj1.json", "JSON", 4, 0, 0, 0, 0, 0, 0, 4
"c:\Users\eloua\OneDrive\Bureau\DiscordJS\ObanaiDiscordBot\src\elements\pnjs\pnj2.json", "JSON", 4, 0, 0, 0, 0, 0, 0, 4
"c:\Users\eloua\OneDrive\Bureau\DiscordJS\ObanaiDiscordBot\src\elements\pnjs\pnj3.json", "JSON", 4, 0, 0, 0, 0, 0, 0, 4
"c:\Users\eloua\OneDrive\Bureau\DiscordJS\ObanaiDiscordBot\src\elements\pnjs\pnj4.json", "JSON", 4, 0, 0, 0, 0, 0, 0, 4
"c:\Users\eloua\OneDrive\Bureau\DiscordJS\ObanaiDiscordBot\src\elements\pnjs\pnj5.json", "JSON", 4, 0, 0, 0, 0, 0, 0, 4
"c:\Users\eloua\OneDrive\Bureau\DiscordJS\ObanaiDiscordBot\src\elements\pnjs\pnj6.json", "JSON", 4, 0, 0, 0, 0, 0, 0, 4
"c:\Users\eloua\OneDrive\Bureau\DiscordJS\ObanaiDiscordBot\src\elements\storyDatas.json", "JSON", 20, 0, 0, 0, 0, 0, 0, 20
"c:\Users\eloua\OneDrive\Bureau\DiscordJS\ObanaiDiscordBot\src\elements\texts\c1_q1.json", "JSON", 13, 0, 0, 0, 0, 0, 0, 13
"c:\Users\eloua\OneDrive\Bureau\DiscordJS\ObanaiDiscordBot\src\elements\texts\c1_q2.json", "JSON", 11, 0, 0, 0, 0, 0, 0, 11
"c:\Users\eloua\OneDrive\Bureau\DiscordJS\ObanaiDiscordBot\src\elements\texts\c1_q3.json", "JSON", 8, 0, 0, 0, 0, 0, 0, 8
"c:\Users\eloua\OneDrive\Bureau\DiscordJS\ObanaiDiscordBot\src\events\guildCreate.js", "JavaScript", 0, 17, 0, 0, 0, 0, 1, 18
"c:\Users\eloua\OneDrive\Bureau\DiscordJS\ObanaiDiscordBot\src\events\guildDelete.js", "JavaScript", 0, 12, 0, 0, 0, 0, 1, 13
"c:\Users\eloua\OneDrive\Bureau\DiscordJS\ObanaiDiscordBot\src\events\messageCreate.js", "JavaScript", 0, 149, 0, 0, 0, 0, 25, 174
"c:\Users\eloua\OneDrive\Bureau\DiscordJS\ObanaiDiscordBot\src\events\ready.js", "JavaScript", 0, 10, 0, 0, 0, 0, 2, 12
"c:\Users\eloua\OneDrive\Bureau\DiscordJS\ObanaiDiscordBot\src\index.js", "JavaScript", 0, 12, 0, 0, 0, 3, 3, 18
"c:\Users\eloua\OneDrive\Bureau\DiscordJS\ObanaiDiscordBot\src\quests\bases\DailyQuest.js", "JavaScript", 0, 7, 0, 0, 0, 0, 2, 9
"c:\Users\eloua\OneDrive\Bureau\DiscordJS\ObanaiDiscordBot\src\quests\bases\QuestBase.js", "JavaScript", 0, 14, 0, 0, 0, 0, 1, 15
"c:\Users\eloua\OneDrive\Bureau\DiscordJS\ObanaiDiscordBot\src\quests\bases\SlayerQuest.js", "JavaScript", 0, 9, 0, 0, 0, 0, 3, 12
"c:\Users\eloua\OneDrive\Bureau\DiscordJS\ObanaiDiscordBot\src\quests\bases\objectives\CollectKItems.js", "JavaScript", 0, 14, 0, 0, 0, 0, 1, 15
"c:\Users\eloua\OneDrive\Bureau\DiscordJS\ObanaiDiscordBot\src\quests\bases\objectives\CollectKYens.js", "JavaScript", 0, 11, 0, 0, 0, 0, 1, 12
"c:\Users\eloua\OneDrive\Bureau\DiscordJS\ObanaiDiscordBot\src\quests\bases\objectives\EarnXp.js", "JavaScript", 0, 11, 0, 0, 0, 0, 1, 12
"c:\Users\eloua\OneDrive\Bureau\DiscordJS\ObanaiDiscordBot\src\quests\bases\objectives\EquipGrimoire.js", "JavaScript", 0, 11, 0, 0, 0, 0, 1, 12
"c:\Users\eloua\OneDrive\Bureau\DiscordJS\ObanaiDiscordBot\src\quests\bases\objectives\FeedCrow.js", "JavaScript", 0, 11, 0, 0, 0, 0, 1, 12
"c:\Users\eloua\OneDrive\Bureau\DiscordJS\ObanaiDiscordBot\src\quests\bases\objectives\TrainStat.js", "JavaScript", 0, 11, 0, 0, 0, 0, 1, 12
"c:\Users\eloua\OneDrive\Bureau\DiscordJS\ObanaiDiscordBot\src\quests\bases\objectives\VoyageTo.js", "JavaScript", 0, 17, 0, 0, 0, 0, 2, 19
"c:\Users\eloua\OneDrive\Bureau\DiscordJS\ObanaiDiscordBot\src\quests\bases\superobjectives\GiveKItems.js", "JavaScript", 0, 21, 0, 0, 0, 0, 2, 23
"c:\Users\eloua\OneDrive\Bureau\DiscordJS\ObanaiDiscordBot\src\quests\bases\superobjectives\InspectArea.js", "JavaScript", 0, 19, 0, 0, 0, 0, 2, 21
"c:\Users\eloua\OneDrive\Bureau\DiscordJS\ObanaiDiscordBot\src\quests\bases\superobjectives\Talk.js", "JavaScript", 0, 17, 0, 0, 0, 0, 2, 19
"c:\Users\eloua\OneDrive\Bureau\DiscordJS\ObanaiDiscordBot\src\quests\daily\dq0.js", "JavaScript", 0, 14, 0, 0, 0, 0, 2, 16
"c:\Users\eloua\OneDrive\Bureau\DiscordJS\ObanaiDiscordBot\src\quests\daily\dq1.js", "JavaScript", 0, 14, 0, 0, 0, 0, 2, 16
"c:\Users\eloua\OneDrive\Bureau\DiscordJS\ObanaiDiscordBot\src\quests\daily\dq2.js", "JavaScript", 0, 14, 0, 0, 0, 0, 2, 16
"c:\Users\eloua\OneDrive\Bureau\DiscordJS\ObanaiDiscordBot\src\quests\slayer\chapter1\quest1.js", "JavaScript", 0, 122, 0, 0, 0, 0, 3, 125
"c:\Users\eloua\OneDrive\Bureau\DiscordJS\ObanaiDiscordBot\src\quests\slayer\chapter1\quest2.js", "JavaScript", 0, 38, 0, 0, 0, 0, 3, 41
"c:\Users\eloua\OneDrive\Bureau\DiscordJS\ObanaiDiscordBot\src\quests\slayer\chapter1\quest3.js", "JavaScript", 0, 38, 0, 0, 0, 0, 3, 41
"c:\Users\eloua\OneDrive\Bureau\DiscordJS\ObanaiDiscordBot\src\structure\callbacks\AlertRequest.js", "JavaScript", 0, 65, 0, 0, 0, 0, 5, 70
"c:\Users\eloua\OneDrive\Bureau\DiscordJS\ObanaiDiscordBot\src\structure\callbacks\InventoryDbCallback.js", "JavaScript", 0, 67, 0, 0, 0, 1, 16, 84
"c:\Users\eloua\OneDrive\Bureau\DiscordJS\ObanaiDiscordBot\src\structure\callbacks\MapDbCallback.js", "JavaScript", 0, 20, 0, 0, 0, 0, 6, 26
"c:\Users\eloua\OneDrive\Bureau\DiscordJS\ObanaiDiscordBot\src\structure\callbacks\PlayerDbCallback.js", "JavaScript", 0, 33, 0, 0, 0, 1, 9, 43
"c:\Users\eloua\OneDrive\Bureau\DiscordJS\ObanaiDiscordBot\src\structure\callbacks\UpdateQuest.js", "JavaScript", 0, 9, 0, 0, 0, 0, 2, 11
"c:\Users\eloua\OneDrive\Bureau\DiscordJS\ObanaiDiscordBot\src\structure\database\ActivityDb.js", "JavaScript", 0, 131, 0, 0, 0, 2, 30, 163
"c:\Users\eloua\OneDrive\Bureau\DiscordJS\ObanaiDiscordBot\src\structure\database\ExternalServerDb.js", "JavaScript", 0, 266, 0, 0, 0, 1, 26, 293
"c:\Users\eloua\OneDrive\Bureau\DiscordJS\ObanaiDiscordBot\src\structure\database\GuildDb.js", "JavaScript", 0, 34, 0, 0, 0, 0, 11, 45
"c:\Users\eloua\OneDrive\Bureau\DiscordJS\ObanaiDiscordBot\src\structure\database\InternalServerManager.js", "JavaScript", 0, 275, 0, 0, 0, 3, 48, 326
"c:\Users\eloua\OneDrive\Bureau\DiscordJS\ObanaiDiscordBot\src\structure\database\InventoryDb.js", "JavaScript", 0, 143, 0, 0, 0, 0, 43, 186
"c:\Users\eloua\OneDrive\Bureau\DiscordJS\ObanaiDiscordBot\src\structure\database\MapDb.js", "JavaScript", 0, 26, 0, 0, 0, 0, 8, 34
"c:\Users\eloua\OneDrive\Bureau\DiscordJS\ObanaiDiscordBot\src\structure\database\PlayerDb.js", "JavaScript", 0, 148, 0, 0, 0, 0, 37, 185
"c:\Users\eloua\OneDrive\Bureau\DiscordJS\ObanaiDiscordBot\src\structure\database\QuestDb.js", "JavaScript", 0, 31, 0, 0, 0, 0, 8, 39
"c:\Users\eloua\OneDrive\Bureau\DiscordJS\ObanaiDiscordBot\src\structure\database\SquadDb.js", "JavaScript", 0, 109, 0, 0, 0, 4, 37, 150
"c:\Users\eloua\OneDrive\Bureau\DiscordJS\ObanaiDiscordBot\src\structure\database\StatusDb.js", "JavaScript", 0, 74, 0, 0, 0, 1, 18, 93
"c:\Users\eloua\OneDrive\Bureau\DiscordJS\ObanaiDiscordBot\src\structure\tools\MemberScanning.js", "JavaScript", 0, 82, 0, 0, 0, 0, 13, 95
"c:\Users\eloua\OneDrive\Bureau\DiscordJS\ObanaiDiscordBot\src\utils\compareArrays.js", "JavaScript", 0, 11, 0, 0, 0, 0, 2, 13
"c:\Users\eloua\OneDrive\Bureau\DiscordJS\ObanaiDiscordBot\src\utils\convertDate.js", "JavaScript", 0, 53, 0, 0, 0, 0, 4, 57
"c:\Users\eloua\OneDrive\Bureau\DiscordJS\ObanaiDiscordBot\src\utils\coolNameGenerator.js", "JavaScript", 0, 57, 0, 0, 0, 0, 7, 64
"c:\Users\eloua\OneDrive\Bureau\DiscordJS\ObanaiDiscordBot\src\utils\dateRender.js", "JavaScript", 0, 16, 0, 0, 0, 0, 1, 17
"c:\Users\eloua\OneDrive\Bureau\DiscordJS\ObanaiDiscordBot\src\utils\delay.js", "JavaScript", 0, 2, 0, 0, 0, 0, 1, 3
"c:\Users\eloua\OneDrive\Bureau\DiscordJS\ObanaiDiscordBot\src\utils\eventLoader.js", "JavaScript", 0, 13, 0, 0, 0, 0, 2, 15
"c:\Users\eloua\OneDrive\Bureau\DiscordJS\ObanaiDiscordBot\src\utils\intRender.js", "JavaScript", 0, 10, 0, 0, 0, 0, 3, 13
"c:\Users\eloua\OneDrive\Bureau\DiscordJS\ObanaiDiscordBot\src\utils\json\replies.json", "JSON", 36, 0, 0, 0, 0, 0, 0, 36
"Total", "-", 8328, 8298, 47, 38, 2506, 86, 1461, 20764